     XXXXXXXXXXXX XXXX
     X  !    X       X
     X       X       X
XXXXXXXXXXXxXXXXXXXxXXXXXX
X      <                 X
X                    XHHHX
                     H   X
X                    H   X
XXXXXXXXXXXXXXXXXXXXXXXXXX
