XXXXXXXXXXXXXXXXXXXXXX
X       O    X       X
X            X       X
XXXXXXXXXXxXXXXXXXxXXX
X      <             X
X                    X
X                    X
X                    X
XXXXXXXXXXXX XXXXXXXXX
