XXXXXYXXXXXXXXXX
X              X
X  XHHX  XHXHX X
X  X  X    H   X
X  XHHX  XHXHX X
X         >    X
XX XHX XHX XHX X
X              X
X              X
XXXXXXXX XXXXXXX
